// DIMENSION 

20 20
// 4 uprising 
// Floor Graph 6 rotating  
//1 2 3 4 6 6 7 8 9
3 3 3 3 3 3 3 3 3 3 3 3 3 3 1 1 3 3 3 3  
3 8 1 1 1 1 1 1 1 1 1 1 1 1 1 1 2 1 1 3 
3 1 4 1 1 1 1 1 1 1 1 1 1 1 1 1 1 1 1 3 
3 1 1 7 1 1 1 9 1 1 1 1 1 1 1 1 1 1 1 3 
3 1 4 3 2 1 1 1 1 1 1 1 1 4 1 2 1 1 1 3 
3 1 9 1 1 4 1 1 1 1 1 1 1 1 1 1 1 1 1 3 
3 1 9 1 1 1 1 1 9 1 1 1 1 1 1 1 2 1 1 3  
3 1 9 1 8 1 1 1 1 1 1 1 1 1 2 1 1 1 1 3 
3 1 2 1 1 1 1 1 1 1 1 1 1 1 1 1 2 1 1 3 
3 1 9 1 1 1 1 1 1 1 1 1 1 1 1 1 1 1 1 3 
3 1 3 1 1 1 3 1 9 1 1 1 1 1 1 1 1 1 1 3 
3 1 1 1 1 1 1 1 1 1 1 1 1 1 3 1 1 1 1 3 
3 1 9 1 1 1 3 9 1 1 1 1 1 1 1 1 2 1 1 3 
3 1 1 1 1 1 1 1 1 1 1 1 1 1 1 1 1 1 1 3 
3 2 2 1 1 1 1 9 1 1 1 1 1 3 1 1 1 1 1 3 
3 1 1 1 1 3 1 9 1 1 1 1 1 1 1 1 1 1 1 3 
3 1 1 1 1 1 9 1 1 1 1 1 1 1 1 4 1 1 1 3 
3 1 1 4 1 1 1 1 1 1 1 1 3 1 1 1 1 1 1 3 
3 1 1 1 1 1 1 4 4 4 4 1 3 1 1 1 1 1 1 3 
3 3 3 3 3 3 3 3 3 3 3 3 3 3 3 3 3 3 3 3 


0 0 0 0 0 0 0 0 0 0 0 0 0 0 0 0 0 0 0 0
0 0 0 0 0 0 0 7 0 0 0 2 0 0 0 0 0 3 0 0
0 0 0 0 0 0 0 5 0 4 0 2 0 1 1 1 0 0 0 0
0 0 0 0 0 0 0 7 0 0 0 0 0 0 0 0 0 0 0 4
0 0 3 4 0 0 5 5 7 7 0 0 7 7 0 0 3 0 0 0
0 0 0 0 0 0 0 0 0 0 0 0 0 0 0 0 0 0 0 0
0 0 0 0 0 0 0 0 0 0 0 0 0 0 0 0 0 0 0 0
0 0 1 0 1 0 0 8 8 0 0 0 0 0 0 0 0 0 0 0
0 0 0 0 0 0 0 8 8 0 0 0 0 0 0 0 0 0 0 0
0 0 0 0 0 0 0 0 0 0 0 0 0 0 0 0 0 0 0 0
0 0 0 0 0 1 0 0 0 0 0 0 0 0 0 0 0 0 0 0
0 0 0 0 0 0 0 0 0 0 0 0 0 0 0 0 0 0 0 0
0 0 4 0 0 1 0 0 0 0 0 5 7 7 5 7 5 7 7 7
0 0 0 0 0 0 0 0 0 0 0 5 0 0 0 0 0 0 0 0
0 0 0 0 0 0 0 0 0 0 0 5 1 2 3 4 0 0 0 0
0 2 0 1 0 0 0 0 0 0 0 5 1 2 3 4 0 0 0 0
0 0 0 0 0 2 0 0 0 0 0 5 1 2 3 4 0 0 0 0
0 0 3 0 0 0 0 0 0 0 0 0 0 0 0 0 0 0 0 4
0 0 0 0 0 0 0 0 0 0 0 0 0 0 0 1 0 0 2 0
0 0 0 0 0 0 0 0 0 0 0 0 0 0 0 0 0 0 0 0

10.0 3.0 -2.0
