// DIMENSION 

20 20

// Floor Graph 
//1 2 3 4 5 6 7 8 9
1 1 3 1 4 1 3 1 1 1 1 1 3 1 4 5 3 1 1 1  
1 2 1 1 1 1 1 1 1 1 1 1 3 1 4 5 3 1 1 1 
3 1 4 3 1 1 3 1 1 4 1 1 3 1 4 5 3 1 1 1 
1 1 3 4 1 1 1 1 1 1 1 1 3 1 4 5 3 1 1 1 
1 1 1 1 1 1 1 1 1 1 1 1 3 1 4 1 3 1 1 1 
1 2 1 1 1 1 1 1 1 1 1 1 3 1 4 1 3 1 1 1 
1 1 1 5 1 1 2 1 1 1 1 1 3 1 4 1 3 1 1 1  
1 1 1 1 1 1 1 1 1 1 1 1 3 1 4 1 3 1 1 1 
1 1 1 1 1 6 1 1 1 1 1 1 3 1 4 1 3 1 1 1 
1 4 1 1 1 1 1 1 1 1 1 1 3 1 4 1 3 1 1 1 
1 1 3 1 4 1 3 1 1 1 1 1 3 1 4 1 3 1 1 1 
1 2 1 1 1 1 1 1 1 1 1 1 3 1 4 1 3 1 1 1 
3 1 4 1 1 1 3 1 1 4 1 1 3 1 4 1 3 1 1 1 
1 1 1 4 1 1 1 1 1 1 1 1 3 1 4 1 3 1 1 1 
1 1 1 1 1 1 1 1 1 1 1 1 3 1 4 1 3 1 1 1 
1 2 1 1 1 1 1 1 1 1 1 1 3 1 4 1 3 1 1 1 
1 1 1 5 1 1 2 1 1 1 1 1 3 1 4 1 3 1 1 1 
1 1 1 1 1 1 1 1 1 1 1 1 3 1 4 1 3 1 1 1 
1 1 1 1 1 6 1 1 1 1 1 1 3 1 4 1 3 1 1 1 
1 4 1 1 1 1 1 1 1 1 1 1 3 1 4 1 3 1 1 1 


0 0 0 2 1 5 3 0 0 0 0 0 5 0 1 5 3 0 0 0
1 0 0 0 0 5 0 0 0 0 0 0 5 0 1 5 3 0 0 0
0 0 0 0 0 5 0 5 0 0 5 0 5 0 1 0 3 0 0 0
0 0 0 0 1 5 0 5 0 0 5 0 5 0 1 5 3 0 0 0
5 5 5 5 5 5 0 5 0 0 5 0 5 0 1 0 3 0 0 0
0 0 0 0 0 0 0 5 0 6 5 0 1 0 1 0 3 0 0 0
0 0 0 0 0 0 0 5 0 0 0 0 1 0 1 0 3 0 0 0
0 4 0 0 0 0 0 0 0 0 0 0 1 0 1 0 3 0 0 0
0 0 0 0 6 0 0 0 0 0 0 0 1 0 1 0 3 0 0 0
0 0 0 0 0 0 0 0 0 0 0 0 1 0 1 0 3 0 0 0
0 0 1 0 1 0 3 0 0 0 0 0 1 0 1 0 3 0 0 0
1 0 0 0 0 0 0 0 0 0 0 0 1 0 1 0 3 0 0 0
0 0 0 0 0 0 0 0 0 0 0 0 1 0 1 0 3 0 0 0
0 0 0 0 0 0 0 0 0 0 0 0 1 0 1 0 3 0 0 0
1 0 0 0 0 0 0 0 0 0 0 0 1 0 1 0 3 0 0 0
0 0 0 0 0 0 0 0 0 0 0 0 1 0 1 0 3 0 0 0
0 0 0 0 0 0 0 0 0 0 0 0 1 0 1 0 3 0 0 0
0 4 0 0 0 0 0 0 0 0 0 0 1 0 1 0 3 0 0 0
0 0 0 0 0 0 0 0 0 0 0 0 1 0 1 0 3 0 0 0
0 0 0 0 0 0 0 0 0 0 0 0 1 0 1 0 3 0 0 0


